60 0 0 0 60 60 60 60 60 60 60 60 60 60 60 60
60 0 0 0 0 0 0 0 0 0 0 0 0 0 0 60
60 0 0 0 0 0 0 0 0 0 0 0 0 0 0 60
60 0 0 0 0 0 0 0 0 0 0 0 0 0 0 60
60 0 0 0 0 0 0 0 0 0 0 0 0 0 0 60
60 0 0 0 0 0 0 0 0 0 0 0 0 0 0 60
60 0 0 0 0 0 0 0 0 0 0 0 0 0 0 60
60 0 0 0 0 0 0 0 0 0 0 0 0 0 0 60
60 0 0 0 0 0 0 0 0 0 0 0 0 0 0 60
60 0 0 0 0 0 0 0 0 0 0 0 0 0 0 60
60 0 0 0 0 0 0 0 0 0 0 0 0 0 0 60
60 0 0 0 0 0 0 0 0 0 0 0 0 0 0 60
60 0 0 0 0 0 0 0 0 0 0 0 0 0 0 60
60 0 0 0 0 0 0 0 0 0 0 0 0 0 0 60
60 0 0 0 0 0 0 0 0 0 0 0 0 0 0 60
60 0 0 0 0 0 0 0 0 0 0 0 0 0 0 60
60 60 60 60 60 60 60 0 0 0 60 60 60 60 60 60
