68 -1 -1 -1 68 68 68 68 68 68 68 68 68 68 68 68
68 0 0 0 0 0 1 1 1 0 0 0 0 0 0 68
68 0 0 0 0 0 0 0 0 0 0 0 0 0 0 68
68 0 0 0 0 0 0 0 0 0 0 0 0 0 0 68
68 0 0 0 0 0 0 0 0 0 0 0 0 0 0 68
68 0 0 0 0 0 0 0 0 0 0 0 0 0 0 68
68 0 0 0 0 0 0 0 0 0 0 0 0 0 0 68
68 0 0 0 0 0 0 0 0 0 0 0 0 0 0 68
68 160 161 162 163 0 0 0 0 0 0 0 0 0 0 68
68 0 0 0 0 0 0 0 0 0 0 0 0 0 0 68
68 0 0 0 0 0 0 0 0 0 0 0 0 0 0 68
68 0 0 0 0 0 0 0 0 0 0 0 0 0 0 68
68 0 0 0 0 0 0 0 0 0 0 0 0 0 0 68
68 0 0 0 0 0 0 0 0 0 0 0 0 0 0 68
68 0 0 0 0 0 0 0 0 0 0 0 0 0 0 68
68 0 0 0 0 0 0 0 0 0 0 0 0 0 0 68
68 68 68 68 68 68 68 -1 -1 -1 68 68 68 68 68 68
