16 2 2 2 18 1 1 1 1 1 1 1 1 1 1 1
16 2 2 2 18 1 1 1 1 1 1 1 1 1 1 1
16 2 2 2 33 9 9 9 9 9 10 1 1 1 1 1
16 2 2 2 2 2 2 2 2 2 18 1 1 1 1 1
16 2 2 2 2 2 2 2 2 2 18 1 1 1 1 1
16 2 2 2 2 2 2 2 2 2 18 1 1 1 1 1
24 25 25 25 25 25 40 2 2 2 18 1 1 1 1 1
1 1 1 1 1 1 16 2 2 2 18 1 1 1 1 1
1 1 1 1 1 1 16 2 2 2 18 1 1 1 1 1
1 1 1 1 1 1 16 2 2 2 18 1 1 1 1 1
1 1 1 1 1 1 16 2 2 2 18 1 1 1 1 1
1 1 1 1 1 1 16 2 2 2 18 1 1 1 1 1
1 1 1 1 1 1 16 2 2 2 18 1 1 1 1 1
1 1 1 1 1 1 16 2 2 2 18 1 1 1 1 1
1 1 1 1 1 1 16 2 2 2 18 1 1 1 1 1
1 1 1 1 1 1 16 2 2 2 18 1 1 1 1 1
1 1 1 1 1 1 16 2 2 2 18 1 1 1 1 1
