32 2 2 2 34 1 1 1 1 1 1 1 1 1 1 1
32 2 2 2 34 1 0 0 1 1 1 1 1 1 1 1
32 2 2 2 36 17 17 17 17 17 18 1 1 1 1 1
32 2 2 2 2 2 2 2 2 2 34 1 1 1 1 1
32 2 2 2 2 2 2 2 2 2 34 1 1 1 1 1
32 2 2 2 2 2 2 2 2 2 34 1 1 1 1 1
48 49 49 49 49 49 51 2 2 2 34 1 1 1 1 1
1 1 1 1 1 1 32 2 2 2 34 1 1 1 1 1
1 1 1 1 1 1 32 2 2 2 34 1 1 1 1 1
1 1 1 1 1 1 32 2 2 2 34 1 1 1 1 1
1 1 1 1 1 1 32 2 2 2 34 1 1 1 1 1
1 1 1 1 1 1 32 2 2 2 34 1 1 1 1 1
1 1 1 1 1 1 32 2 2 2 34 1 1 1 1 1
1 1 1 1 1 1 32 2 2 2 34 1 1 1 1 1
1 1 1 1 1 1 32 2 2 2 34 1 1 1 1 1
1 1 1 1 1 1 32 2 2 2 34 1 1 1 1 1
1 1 1 1 1 1 32 2 2 2 34 1 1 1 1 1
